R 1200 700

NO ./northwall_64x64.xpm

SO ./westwall_64x64.xpm
WE ./westwall_64x64.xpm

EA ./northwall_64x64.xpm
S ./rick_3.xpm

F 220,100,234

C 255,123,12



1111111111
1100001001
1101202101
1100002001
11000N0001
1000001111
1111111111
