R 1920 1080


NO ./north_text 
SO ./south_text
WE ./west_text
EA ./east_text
S ./sprite_text
F 220,100,234
C 225,30,123


      111111111111111111111111       1111111111
  1  1000000000110000000000001          111111
  1 11011000001110000002000001          100201
  1  1001000000000000000000001          111111
  11 1111111110110000011100001 1111
  1 1100000000011000001110111111111111
  1  11110111111111011100000010001
    111110111111111011101010010001
    111000000110101011100000010001
  11110002000000000001100000010001
  11110000000000000001101010010001    1111
  1111100000111010101111101111N001    1  1
  1  11110111 1110101 101111010001    1111
  1  11111111 1111111 111111111111
