R 1920 1080

NO ./north_text 

SO ./south_text

WE ./west_text
EA ./east_text
S ./sprite_text
F 220,100,234

C 225,30,123

111111
110001
11N001
100001
111111
