R 1280 720

NO ./textures/wolf/colorstone.xpm

SO ./textures/wolf/eagle.xpm

WE ./textures/wolf/wood.xpm

EA ./textures/street/spray.xpm

S ./textures/wolf/barrel.xpm

C 130, 250, 100
F 91 , 1, 100

        1111111111111111111111111
        1000000000110000000000001
        1011000001110000002000001
        1001000000000000000000001
111111111011000001110000000000001
100000000011000001110111111111111
11110111111111000000000000001
11110111111111011101010000001
11000000110101011100000200001
10002000000000001100000200001
10000000000000001101010000001
11000001110101011111011110N0111
11110111 1110101 101111010001
11111111 1111111 111111111111
