R 1280 720

NO ./north_text 

SO ./south_text

WE ./west_text
EA ./east_text
S ./sprite_text
F 220,100,234

C 225,30,123

1111111111
1100001001
1101000101
1100000001
11000N0001
1000001111
1111111111
