R 1280 720

NO ./textures/wolf/colorstone.xpm

SO ./textures/wolf/eagle.xpm

WE ./textures/wolf/wood.xpm

EA ./textures/street/spray.xpm

S                  ./textures/wolf/barrel.xpm

C 130,         50, 101

F 101, 199,0

1111111111 11111111111
10N000000011011111111111 11111111111 11111111111 11111111111
100022200010000000000011111111111 11111111111 11111111111
10000000001111111111110022222222211111111111111 11111111111
1000000000000000000000000002000000000000000000111111111111
100000000011111111111111111111111111111111111111111111111111111111111111111111111111111
11101110111
1110000001
1100000001
1110001111
100000001
110001111
122222221
122222221
122222221
122222221
11111111111111111111111111111111111111111111111111111111111111
