R 1920 1080

WE ./textures/wolf/wood.xpm

EA ./textures/street/spray.xpm

NO ./textures/wolf/colorstone.xpm

S ./textures/wolf/barrel.xpm

SO ./textures/wolf/eagle.xpm

C 120, 100, 240

F 50, 190, 90

        1111111111111111111111111
        1000000000110000000000001
        1011000001110020002000001
        1001000000000000200000001
111111111011000001110000000002001
100000000011000001110101100111111
11110111111111011100000010001
11110111111111011101010000001
11000000110101011100000000001
10002000000000001100020010001
10000000000000001101010010001
11000001110101011111011110N0111
11110111 1110101 101111010001
11111111 1111111 111111111111
