R 1200 700

NO ./northwall_64x64.xpm

SO ./westwall_64x64.xpm
WE ./westwall_64x64.xpm

EA ./northwall_64x64.xpm
S ./rick_3.xpm

F 220,199,234

C 000,000,12



1111111111
1122221221
1122222101
1100020001
11N2222201
1000001111
1111111111
