R 1280 720

NO ./westwall_64x64.xpm

SO ./westwall_64x64.xpm
WE ./westwall_64x64.xpm

EA ./northwall_64x64.xpm
S ./rick_3.xpm

F 220,199,234

C 000, 000, 000

11111111111111111
10000000000000001
10000000000000001
10000000N00000001
10000000000000001
11111111111111111
